thrL	thrL
thrA	thrA
thrB	thrB
thrC	thrC
yaaX	yaaX
yaaA	yaaA
yaaJ	yaaJ
talB	talB
mog	mog
yaaH	yaaH
yaaW	yaaW
htgA	htgA
yaaI	yaaI
dnaK	dnaK
dnaJ	dnaJ
insL-1	insL-1
insL-2	insL-2
insL-3	insL-3
hokC	hokC
mokC	mokC
nhaA	nhaA
nhaR	nhaR
insB-1	insB-1
insB-2	insB-2
insB-3	insB-3
insB-4	insB-4
insB-6	insB-6
insB-7_1	insB-7_1
insB-7_2	insB-7_2
insB-7	insB-7
insB	insB
insA-1	insA-1
insA-2	insA-2
insA-3	insA-3
insA-6	insA-6
insA-7	insA-7
insA-4	insA-4
insA	insA
rpsT	rpsT
yaaY	yaaY
ribF	ribF
ileS	ileS
lspA	lspA
fkpB	fkpB
ispH	ispH
rihC	rihC
dapB	dapB
carA	carA
carB	carB
caiF	caiF
caiE	caiE
caiD	caiD
caiC	caiC
caiB	caiB
caiA	caiA
caiT	caiT
fixA	fixA
fixB	fixB
fixC	fixC
fixX	fixX
yaaU	yaaU
kefF	kefF
kefC	kefC
folA	folA
apaH	apaH
apaG	apaG
ksgA	ksgA
pdxA	pdxA
surA	surA
imp	imp
djlA	djlA
yabP	yabP
yabQ	yabQ
rluA	rluA
hepA	hepA
polB	polB
araD	araD
araA	araA
araB	araB
araC	araC
yabI	yabI
thiQ	thiQ
thiP	thiP
tbpA	tbpA
sgrR	sgrR
sgrS	sgrS
setA	setA
leuD	leuD
leuC	leuC
leuB	leuB
leuA	leuA
leuL	leuL
leuO	leuO
ilvI	ilvI
ilvH	ilvH
fruR	fruR
mraZ	mraZ
mraW	mraW
ftsL	ftsL
ftsI	ftsI
murE	murE
murF	murF
mraY	mraY
murD	murD
ftsW	ftsW
murG	murG
murC	murC
ddlB	ddlB
ftsQ	ftsQ
ftsA	ftsA
ftsZ	ftsZ
lpxC	lpxC
secM	secM
secA	secA
mutT	mutT
yacG	yacG
yacF	yacF
coaE	coaE
guaC	guaC
hofC	hofC
hofB	hofB
ppdD	ppdD
nadC	nadC
ampD	ampD
ampE	ampE
aroP	aroP
pdhR	pdhR
aceE	aceE
aceF	aceF
lpd	lpd
yacH	yacH
acnB	acnB
yacL	yacL
speD	speD
speE	speE
yacC	yacC
cueO	cueO
gcd	gcd
hpt	hpt
can	can
yadG	yadG
yadH	yadH
yadI	yadI
yadE	yadE
panD	panD
yadD	yadD
panC	panC
panB	panB
yadC	yadC
yadK	yadK
yadL	yadL
yadM	yadM
htrE	htrE
ecpD	ecpD
yadN	yadN
folK	folK
pcnB	pcnB
yadB	yadB
dksA	dksA
sfsA	sfsA
ligT	ligT
hrpB	hrpB
mrcB	mrcB
fhuA	fhuA
fhuC	fhuC
fhuD	fhuD
fhuB	fhuB
hemL	hemL
clcA	clcA
yadR	yadR
yadS	yadS
btuF	btuF
pfs	pfs
dgt	dgt
degP	degP
cdaR	cdaR
yaeH	yaeH
yaeI	yaeI
dapD	dapD
glnD	glnD
map	map
t44	t44
rpsB	rpsB
tsf	tsf
pyrH	pyrH
frr	frr
dxr	dxr
ispU	ispU
cdsA	cdsA
yaeL	yaeL
yaeT	yaeT
hlpA	hlpA
lpxD	lpxD
fabZ	fabZ
lpxA	lpxA
lpxB	lpxB
rnhB	rnhB
dnaE	dnaE
accA	accA
ldcC	ldcC
yaeR	yaeR
tilS	tilS
rof	rof
yaeP	yaeP
yaeQ	yaeQ
yaeJ	yaeJ
nlpE	nlpE
yaeF	yaeF
proS	proS
yaeB	yaeB
rcsF	rcsF
metQ	metQ
metI	metI
metN	metN
gmhB	gmhB
rrsH	rrsH
ileV	ileV
alaV	alaV
rrlH	rrlH
rrfH	rrfH
aspU	aspU
dkgB	dkgB
yafC	yafC
yafD	yafD
yafE	yafE
mltD	mltD
gloB	gloB
yafS	yafS
rnhA	rnhA
dnaQ	dnaQ
aspV	aspV
yafT	yafT
yafU	yafU
yafF	yafF
yafV	yafV
ivy	ivy
fadE	fadE
lpcA	lpcA
yafJ	yafJ
yafK	yafK
yafQ	yafQ
dinJ	dinJ
yafL	yafL
yafM	yafM
fhiA	fhiA
mbhA	mbhA
dinB	dinB
yafN	yafN
yafO	yafO
yafP	yafP
ykfJ	ykfJ
prfH	prfH
pepD	pepD
gpt	gpt
frsA	frsA
crl	crl
phoE	phoE
proB	proB
proA	proA
thrW	thrW
ykfI	ykfI
yafW	yafW
ykfH	ykfH
ykfG	ykfG
yafX	yafX
ykfF	ykfF
ykfB	ykfB
yafY	yafY
yafZ	yafZ
ykfA	ykfA
perR	perR
insN-1	insN-1
insN-2	insN-2
insI-1	insI-1
insI-2	insI-2
insI-3	insI-3
insO-1	insO-1
ykfC	ykfC
insH-1	insH-1
insH-2	insH-2
insH-3	insH-3
insH-4	insH-4
insH-5	insH-5
insH-6	insH-6
insH-7	insH-7
insH-8	insH-8
insH-9	insH-9
insH-10	insH-10
insH-11	insH-11
insH	insH
mmuP	mmuP
mmuM	mmuM
afuC	afuC
afuB	afuB
ykgN	ykgN
yagB	yagB
yagA	yagA
yagE	yagE
yagF	yagF
yagG	yagG
yagH	yagH
yagI	yagI
argF	argF
yagJ	yagJ
yagK	yagK
yagL	yagL
yagM	yagM
yagN	yagN
intF	intF
yagP	yagP
yagQ	yagQ
yagR	yagR
yagS	yagS
yagT	yagT
yagU	yagU
ykgJ	ykgJ
yagV	yagV
yagW	yagW
yagX	yagX
yagY	yagY
yagZ	yagZ
ykgK	ykgK
ykgL	ykgL
ykgM	ykgM
eaeH	eaeH
insE-1	insE-1
insE-2	insE-2
insE-3	insE-3
insE-4	insE-4
insE-5	insE-5
insF-1	insF-1
insF-2	insF-2
insF-3	insF-3
insF-4	insF-4
insF-5	insF-5
ykgA	ykgA
ykgB	ykgB
ykgI	ykgI
ykgC	ykgC
ykgD	ykgD
ykgE	ykgE
ykgF	ykgF
ykgG	ykgG
ykgH	ykgH
betA	betA
betB	betB
betI	betI
betT	betT
yahA	yahA
yahB	yahB
yahC	yahC
yahD	yahD
yahE	yahE
yahF	yahF
yahG	yahG
yahH	yahH
yahI	yahI
yahJ	yahJ
yahK	yahK
yahL	yahL
yahM	yahM
yahN	yahN
yahO	yahO
prpR	prpR
prpB	prpB
prpC	prpC
prpD	prpD
prpE	prpE
codB	codB
codA	codA
cynR	cynR
cynT	cynT
cynS	cynS
cynX	cynX
lacA	lacA
lacY	lacY
lacZ	lacZ
lacI	lacI
mhpR	mhpR
mhpA	mhpA
mhpB	mhpB
mhpC	mhpC
mhpD	mhpD
mhpF	mhpF
mhpE	mhpE
mhpT	mhpT
yaiL	yaiL
frmB	frmB
frmA	frmA
frmR	frmR
yaiO	yaiO
yaiX	yaiX
insC-1	insC-1
insC-2	insC-2
insC-3	insC-3
insC-4	insC-4
insC-5	insC-5
insC-6	insC-6
insC	insC
insD-1	insD-1
insD-2	insD-2
insD-3	insD-3
insD-4	insD-4
insD-5	insD-5
insD-6	insD-6
insD	insD
yaiF	yaiF
yaiP	yaiP
yaiS	yaiS
tauA	tauA
tauB	tauB
tauC	tauC
tauD	tauD
hemB	hemB
ykiB	ykiB
yaiT	yaiT
yaiU	yaiU
yaiV	yaiV
ampH	ampH
sbmA	sbmA
yaiW	yaiW
yaiY	yaiY
yaiZ	yaiZ
ddlA	ddlA
yaiB	yaiB
phoA	phoA
psiF	psiF
yaiC	yaiC
proC	proC
yaiI	yaiI
aroL	aroL
yaiA	yaiA
aroM	aroM
yaiE	yaiE
ykiA	ykiA
rdgC	rdgC
mak	mak
araJ	araJ
sbcC	sbcC
sbcD	sbcD
phoB	phoB
phoR	phoR
brnQ	brnQ
proY	proY
malZ	malZ
yajB	yajB
queA	queA
tgt	tgt
yajC	yajC
secD	secD
secF	secF
yajD	yajD
tsx	tsx
yajI	yajI
ybaD	ybaD
ribD	ribD
ribE	ribE
nusB	nusB
thiL	thiL
pgpA	pgpA
yajO	yajO
dxs	dxs
ispA	ispA
xseB	xseB
thiI	thiI
yajL	yajL
panE	panE
yajQ	yajQ
yajR	yajR
cyoE	cyoE
cyoD	cyoD
cyoC	cyoC
cyoB	cyoB
cyoA	cyoA
ampG	ampG
yajG	yajG
bolA	bolA
tig	tig
clpP	clpP
clpX	clpX
lon	lon
hupB	hupB
ppiD	ppiD
ybaV	ybaV
ybaW	ybaW
ybaX	ybaX
ybaE	ybaE
cof	cof
ybaO	ybaO
mdlA	mdlA
mdlB	mdlB
glnK	glnK
amtB	amtB
tesB	tesB
ybaY	ybaY
ybaZ	ybaZ
ffs	ffs
ybaA	ybaA
ylaB	ylaB
ylaC	ylaC
maa	maa
hha	hha
ybaJ	ybaJ
acrB	acrB
acrA	acrA
acrR	acrR
kefA	kefA
ybaM	ybaM
priC	priC
ybaN	ybaN
apt	apt
dnaX	dnaX
ybaB	ybaB
recR	recR
htpG	htpG
adk	adk
hemH	hemH
aes	aes
gsk	gsk
ybaL	ybaL
fsr	fsr
ushA	ushA
ybaK	ybaK
ybaP	ybaP
ybaQ	ybaQ
copA	copA
ybaS	ybaS
ybaT	ybaT
cueR	cueR
ybbJ	ybbJ
ybbK	ybbK
ybbL	ybbL
ybbM	ybbM
ybbN	ybbN
ybbO	ybbO
tesA	tesA
ybbA	ybbA
ybbP	ybbP
rhsD	rhsD
ybbC	ybbC
ylbH	ylbH
ybbD	ybbD
ylbG	ylbG
ybbB	ybbB
ybbS	ybbS
allA	allA
allR	allR
gcl	gcl
hyi	hyi
glxR	glxR
ybbV	ybbV
ybbW	ybbW
allB	allB
ybbY	ybbY
glxK	glxK
ylbA	ylbA
allC	allC
allD	allD
fdrA	fdrA
ylbE_2	ylbE_2
ylbE_1	ylbE_1
ylbE	ylbE
ylbF	ylbF
ybcF	ybcF
purK	purK
purE	purE
lpxH	lpxH
ppiB	ppiB
cysS	cysS
ybcI	ybcI
ybcJ	ybcJ
folD	folD
sfmA	sfmA
sfmC	sfmC
sfmD	sfmD
sfmH	sfmH
sfmF	sfmF
fimZ	fimZ
argU	argU
intD	intD
ybcC	ybcC
ybcD	ybcD
renD	renD
emrE	emrE
ybcK	ybcK
ybcL	ybcL
ybcM	ybcM
ybcN	ybcN
ninE	ninE
ybcO	ybcO
rusA	rusA
ylcG	ylcG
ybcQ	ybcQ
nmpC	nmpC
essD	essD
ybcS	ybcS
rzpD	rzpD
rzoD	rzoD
borD	borD
ybcV	ybcV
ybcW	ybcW
nohB	nohB
tfaD	tfaD
ybcY	ybcY
ylcE	ylcE
appY	appY
ompT	ompT
envY	envY
ybcH	ybcH
nfrA	nfrA
nfrB	nfrB
cusS	cusS
cusR	cusR
cusC	cusC
cusF	cusF
cusB	cusB
cusA	cusA
pheP	pheP
ybdG	ybdG
nfnB	nfnB
ybdF	ybdF
ybdJ	ybdJ
ybdK	ybdK
hokE	hokE
entD	entD
fepA	fepA
fes	fes
ybdZ	ybdZ
entF	entF
fepE	fepE
fepC	fepC
fepG	fepG
fepD	fepD
ybdA	ybdA
fepB	fepB
entC	entC
entE	entE
entB	entB
entA	entA
ybdB	ybdB
cstA	cstA
ybdD	ybdD
ybdH	ybdH
ybdL	ybdL
ybdM	ybdM
ybdN	ybdN
ybdO	ybdO
dsbG	dsbG
ahpC	ahpC
ahpF	ahpF
uspG	uspG
ybdR	ybdR
rnk	rnk
rna	rna
citT	citT
citG	citG
citX	citX
citF	citF
citE	citE
citD	citD
citC	citC
citA	citA
citB	citB
dcuC	dcuC
crcA	crcA
cspE	cspE
crcB	crcB
ybeH	ybeH
ybeM	ybeM
tatE	tatE
lipA	lipA
ybeF	ybeF
lipB	lipB
ybeD	ybeD
dacA	dacA
rlpA	rlpA
mrdB	mrdB
mrdA	mrdA
ybeA	ybeA
ybeB	ybeB
cobC	cobC
nadD	nadD
holA	holA
rlpB	rlpB
leuS	leuS
ybeL	ybeL
ybeQ	ybeQ
ybeR	ybeR
djlB	djlB
ybeT	ybeT
ybeU	ybeU
djlC	djlC
hscC	hscC
rihA	rihA
gltL	gltL
gltK	gltK
gltJ	gltJ
gltI	gltI
lnt	lnt
ybeX	ybeX
ybeY	ybeY
ybeZ	ybeZ
miaB	miaB
ubiF	ubiF
glnX	glnX
glnV	glnV
metU	metU
glnW	glnW
glnU	glnU
leuW	leuW
metT	metT
asnB	asnB
nagD	nagD
nagC	nagC
nagA	nagA
nagB	nagB
nagE	nagE
glnS	glnS
ybfM	ybfM
ybfN	ybfN
fur	fur
fldA	fldA
ybfE	ybfE
ybfF	ybfF
seqA	seqA
pgm	pgm
ybfP	ybfP
ybfG	ybfG
ybfH	ybfH
potE	potE
speF	speF
kdpE	kdpE
kdpD	kdpD
kdpC	kdpC
kdpB	kdpB
kdpA	kdpA
kdpF	kdpF
ybfA	ybfA
rhsC	rhsC
ybfB	ybfB
ybfO	ybfO
ybfC	ybfC
ybfQ	ybfQ
ybfL	ybfL
ybfD	ybfD
ybgA	ybgA
phr	phr
ybgH	ybgH
ybgI	ybgI
ybgJ	ybgJ
ybgK	ybgK
ybgL	ybgL
nei	nei
abrB	abrB
ybgO	ybgO
ybgP	ybgP
ybgQ	ybgQ
ybgD	ybgD
gltA	gltA
sdhC	sdhC
sdhD	sdhD
sdhA	sdhA
sdhB	sdhB
sucA	sucA
sucB	sucB
sucC	sucC
sucD	sucD
mngR	mngR
mngA	mngA
mngB	mngB
cydA	cydA
cydB	cydB
ybgT	ybgT
ybgE	ybgE
ybgC	ybgC
tolQ	tolQ
tolR	tolR
tolA	tolA
tolB	tolB
pal	pal
ybgF	ybgF
lysT	lysT
valT	valT
lysW	lysW
valZ	valZ
lysY	lysY
lysZ	lysZ
lysQ	lysQ
nadA	nadA
pnuC	pnuC
zitB	zitB
ybgS	ybgS
aroG	aroG
gpmA	gpmA
galM	galM
galK	galK
galT	galT
galE	galE
modF	modF
modE	modE
ybhT	ybhT
modA	modA
modB	modB
modC	modC
ybhA	ybhA
ybhE	ybhE
ybhD	ybhD
ybhH	ybhH
ybhI	ybhI
ybhJ	ybhJ
ybhC	ybhC
ybhB	ybhB
bioA	bioA
bioB	bioB
bioF	bioF
bioC	bioC
bioD	bioD
uvrB	uvrB
ybhK	ybhK
moaA	moaA
moaB	moaB
moaC	moaC
moaD	moaD
moaE	moaE
ybhL	ybhL
ybhM	ybhM
ybhN	ybhN
ybhO	ybhO
ybhP	ybhP
ybhQ	ybhQ
ybhR	ybhR
ybhS	ybhS
ybhF	ybhF
ybhG	ybhG
ybiH	ybiH
rhlE	rhlE
ybiA	ybiA
dinG	dinG
ybiB	ybiB
ybiC	ybiC
ybiJ	ybiJ
ybiI	ybiI
ybiX	ybiX
fiu	fiu
ybiM	ybiM
ybiN	ybiN
ybiO	ybiO
glnQ	glnQ
glnP	glnP
glnH	glnH
dps	dps
rhtA	rhtA
ompX	ompX
ybiP	ybiP
yliL	yliL
rybA	rybA
mntR	mntR
ybiR	ybiR
ybiS	ybiS
ybiT	ybiT
ybiU	ybiU
ybiV	ybiV
ybiW	ybiW
ybiY	ybiY
fsaA	fsaA
moeB	moeB
moeA	moeA
iaaA	iaaA
yliA	yliA
yliB	yliB
yliC	yliC
yliD	yliD
yliE	yliE
yliF	yliF
yliG	yliG
yliH	yliH
yliI	yliI
yliJ	yliJ
dacC	dacC
deoR	deoR
ybjG	ybjG
cmr	cmr
ybjH	ybjH
ybjI	ybjI
ybjJ	ybjJ
ybjK	ybjK
rybB	rybB
ybjL	ybjL
ybjM	ybjM
grxA	grxA
ybjC	ybjC
nfsA	nfsA
rimK	rimK
ybjN	ybjN
potF	potF
potG	potG
potH	potH
potI	potI
ybjO	ybjO
rumB	rumB
artJ	artJ
artM	artM
artQ	artQ
artI	artI
artP	artP
ybjP	ybjP
ybjQ	ybjQ
ybjR	ybjR
ybjS	ybjS
ybjT	ybjT
ltaE	ltaE
poxB	poxB
hcr	hcr
hcp	hcp
ybjE	ybjE
aqpZ	aqpZ
ybjD	ybjD
ybjX	ybjX
macA	macA
macB	macB
cspD	cspD
clpS	clpS
clpA	clpA
serW	serW
infA	infA
aat	aat
cydC	cydC
cydD	cydD
trxB	trxB
lrp	lrp
ftsK	ftsK
lolA	lolA
ycaJ	ycaJ
serS	serS
dmsA	dmsA
dmsB	dmsB
dmsC	dmsC
ycaC	ycaC
ycaD	ycaD
ycaM	ycaM
ycaN	ycaN
ycaK	ycaK
pflA	pflA
pflB	pflB
focA	focA
ycaO	ycaO
ycaP	ycaP
serC	serC
aroA	aroA
ycaL	ycaL
cmk	cmk
rpsA	rpsA
ihfB	ihfB
ycaI	ycaI
msbA	msbA
lpxK	lpxK
ycaQ	ycaQ
ycaR	ycaR
kdsB	kdsB
ycbJ	ycbJ
ycbC	ycbC
smtA	smtA
mukF	mukF
mukE	mukE
mukB	mukB
ycbB	ycbB
ycbK	ycbK
ycbL	ycbL
aspC	aspC
ompF	ompF
asnS	asnS
pncB	pncB
pepN	pepN
ssuB	ssuB
ssuC	ssuC
ssuD	ssuD
ssuA	ssuA
ssuE	ssuE
ycbQ	ycbQ
ycbR	ycbR
ycbS	ycbS
ycbT	ycbT
ycbU	ycbU
ycbV	ycbV
ycbF	ycbF
pyrD	pyrD
ycbW	ycbW
ycbX	ycbX
ycbY	ycbY
uup	uup
pqiA	pqiA
pqiB	pqiB
ymbA	ymbA
rmf	rmf
fabA	fabA
ycbZ	ycbZ
ycbG	ycbG
ompA	ompA
sulA	sulA
yccR	yccR
yccS	yccS
yccF	yccF
helD	helD
mgsA	mgsA
yccT	yccT
yccU	yccU
yccV	yccV
yccW	yccW
yccX	yccX
yccK	yccK
yccA	yccA
serT	serT
hyaA	hyaA
hyaB	hyaB
hyaC	hyaC
hyaD	hyaD
hyaE	hyaE
hyaF	hyaF
appC	appC
appB	appB
appA	appA
yccC	yccC
etp	etp
yccZ	yccZ
ymcA	ymcA
ymcB	ymcB
ymcC	ymcC
ymcD	ymcD
cspH	cspH
cspG	cspG
ymcE	ymcE
gnsA	gnsA
yccM	yccM
torS	torS
torT	torT
torR	torR
torC	torC
torA	torA
torD	torD
cbpM	cbpM
cbpA	cbpA
yccE	yccE
agp	agp
yccJ	yccJ
wrbA	wrbA
ymdF	ymdF
ycdG	ycdG
ycdH	ycdH
ycdI	ycdI
rarA	rarA
ycdK	ycdK
ycdL	ycdL
ycdM	ycdM
ycdC	ycdC
putA	putA
putP	putP
ycdN_1	ycdN_1
ycdN_2	ycdN_2
ycdN	ycdN
ycdO	ycdO
ycdB	ycdB
phoH	phoH
ycdP	ycdP
ycdQ	ycdQ
ycdR	ycdR
ycdS	ycdS
ycdT	ycdT
ymdE	ymdE
ycdU	ycdU
serX	serX
ycdW	ycdW
ycdX	ycdX
ycdY	ycdY
ycdZ	ycdZ
csgG	csgG
csgF	csgF
csgE	csgE
csgD	csgD
csgB	csgB
csgA	csgA
csgC	csgC
ymdA	ymdA
ymdB	ymdB
ymdC	ymdC
mdoC	mdoC
mdoG	mdoG
mdoH	mdoH
yceK	yceK
msyB	msyB
mdtG	mdtG
lpxL	lpxL
yceA	yceA
yceI	yceI
yceJ	yceJ
yceO	yceO
solA	solA
yceP	yceP
dinI	dinI
pyrC	pyrC
yceB	yceB
grxB	grxB
mdtH	mdtH
rimJ	rimJ
yceH	yceH
mviM	mviM
mviN	mviN
flgN	flgN
flgM	flgM
flgA	flgA
flgB	flgB
flgC	flgC
flgD	flgD
flgE	flgE
flgF	flgF
flgG	flgG
flgH	flgH
flgI	flgI
flgJ	flgJ
flgK	flgK
flgL	flgL
rne	rne
yceQ	yceQ
rluC	rluC
yceF	yceF
sraB	sraB
yceD	yceD
rpmF	rpmF
plsX	plsX
fabH	fabH
fabD	fabD
fabG	fabG
acpP	acpP
fabF	fabF
pabC	pabC
yceG	yceG
tmk	tmk
holB	holB
ycfH	ycfH
ptsG	ptsG
fhuE	fhuE
hinT	hinT
ycfL	ycfL
ycfM	ycfM
ycfN	ycfN
nagZ	nagZ
ycfP	ycfP
ndh	ndh
ycfJ	ycfJ
ycfQ	ycfQ
ycfR	ycfR
ycfS	ycfS
mfd	mfd
ycfT	ycfT
lolC	lolC
lolD	lolD
lolE	lolE
ycfX	ycfX
cobB	cobB
ycfZ	ycfZ
ymfA	ymfA
potD	potD
potC	potC
potB	potB
potA	potA
pepT	pepT
ycfD	ycfD
phoQ	phoQ
phoP	phoP
purB	purB
hflD	hflD
trmU	trmU
ymfB	ymfB
ymfC	ymfC
icd	icd
ymfD	ymfD
ymfE	ymfE
lit	lit
intE	intE
ymfG	ymfG
ymfH	ymfH
ymfI	ymfI
ymfJ	ymfJ
ymfK	ymfK
ymfT	ymfT
ymfL	ymfL
ymfM	ymfM
ymfN	ymfN
ymfR	ymfR
ymfO	ymfO
ymfP	ymfP
ymfQ	ymfQ
ycfK	ycfK
ymfS	ymfS
tfaE	tfaE
stfE	stfE
pin	pin
mcrA	mcrA
icdC	icdC
elbA	elbA
ycgX	ycgX
ycgE	ycgE
ycgF	ycgF
ycgZ	ycgZ
ymgA	ymgA
ymgB	ymgB
ymgC	ymgC
ycgG	ycgG
ymgF	ymgF
ycgH_1	ycgH_1
ycgH_2	ycgH_2
ycgH	ycgH
ymgD	ymgD
ymgG	ymgG
ymgH	ymgH
ycgI	ycgI
minE	minE
minD	minD
minC	minC
ycgJ	ycgJ
ycgK	ycgK
ycgL	ycgL
ycgM	ycgM
ycgN	ycgN
hlyE	hlyE
umuD	umuD
umuC	umuC
dsbB	dsbB
nhaB	nhaB
fadR	fadR
ycgB	ycgB
dadA	dadA
dadX	dadX
cvrA	cvrA
ldcA	ldcA
emtA	emtA
ycgR	ycgR
ymgE	ymgE
ycgY	ycgY
treA	treA
dhaH	dhaH
dhaL	dhaL
dhaK	dhaK
dhaR	dhaR
ycgV	ycgV
ychF	ychF
pth	pth
ychH	ychH
ychM	ychM
prsA	prsA
ispE	ispE
lolB	lolB
hemA	hemA
prfA	prfA
prmC	prmC
ychQ	ychQ
ychA	ychA
kdsA	kdsA
ldrA	ldrA
rdlA	rdlA
ldrB	ldrB
rdlB	rdlB
ldrC	ldrC
rdlC	rdlC
chaA	chaA
chaB	chaB
chaC	chaC
ychN	ychN
ychP	ychP
narL	narL
narX	narX
narK	narK
narG	narG
narH	narH
narJ	narJ
narI	narI
ychS	ychS
rtT	rtT
tpr	tpr
tyrV	tyrV
tyrT	tyrT
purU	purU
ychJ	ychJ
rssA	rssA
rssB	rssB
galU	galU
hns	hns
tdk	tdk
ychG_2	ychG_2
ychG_1	ychG_1
ychG	ychG
adhE	adhE
ychE	ychE
oppA	oppA
oppB	oppB
oppC	oppC
oppD	oppD
oppF	oppF
yciU	yciU
cls	cls
kch	kch
yciI	yciI
tonB	tonB
yciA	yciA
yciB	yciB
yciC	yciC
ompW	ompW
yciE	yciE
yciF	yciF
yciG	yciG
trpA	trpA
trpB	trpB
trpC	trpC
trpD	trpD
trpE	trpE
yciV	yciV
yciO	yciO
yciQ	yciQ
rluB	rluB
btuR	btuR
yciK	yciK
sohB	sohB
yciN	yciN
topA	topA
cysB	cysB
yciX_1	yciX_1
yciX_2	yciX_2
yciX	yciX
acnA	acnA
ribA	ribA
pgpB	pgpB
yciS	yciS
yciM	yciM
pyrF	pyrF
yciH	yciH
osmB	osmB
yciT	yciT
gmr	gmr
rnb	rnb
yciW	yciW
fabI	fabI
ycjD	ycjD
sapF	sapF
sapD	sapD
sapC	sapC
sapB	sapB
sapA	sapA
ymjA	ymjA
puuP	puuP
puuA	puuA
puuD	puuD
puuR	puuR
puuC	puuC
puuB	puuB
puuE	puuE
pspF	pspF
pspA	pspA
pspB	pspB
pspC	pspC
pspD	pspD
pspE	pspE
ycjM	ycjM
ycjN	ycjN
ycjO	ycjO
ycjP	ycjP
ycjQ	ycjQ
ycjR	ycjR
ycjS	ycjS
ycjT	ycjT
ycjU	ycjU
ycjV	ycjV
ymjB	ymjB
ompG	ompG
ycjW	ycjW
ycjX	ycjX
ycjF	ycjF
tyrR	tyrR
tpx	tpx
ycjG	ycjG
mpaA	mpaA
ymjC	ymjC
ycjY	ycjY
ycjZ	ycjZ
mppA	mppA
ynaI	ynaI
ynaJ	ynaJ
uspE	uspE
fnr	fnr
ogt	ogt
abgT	abgT
abgB	abgB
abgA	abgA
abgR	abgR
IS061	IS061
ydaL	ydaL
ydaM	ydaM
ydaN	ydaN
dbpA	dbpA
ydaO	ydaO
intR	intR
ydaQ	ydaQ
ydaC	ydaC
lar	lar
recT	recT
recE	recE
racC	racC
ydaE	ydaE
kil	kil
sieB	sieB
ydaF	ydaF
ydaG	ydaG
racR	racR
ydaS	ydaS
ydaT	ydaT
ydaU	ydaU
ydaV	ydaV
ydaW	ydaW
rzpR	rzpR
rzoR	rzoR
trkG	trkG
ynaK	ynaK
ydaY	ydaY
ynaA	ynaA
lomR_1	lomR_1
lomR_2	lomR_2
lomR	lomR
stfR	stfR
tfaR	tfaR
pinR	pinR
ynaE	ynaE
uspF	uspF
ompN	ompN
tke8	tke8
ydbK	ydbK
ydbJ	ydbJ
hslJ	hslJ
ldhA	ldhA
ydbH	ydbH
ynbE	ynbE
ydbL	ydbL
feaR	feaR
feaB	feaB
tynA	tynA
maoC	maoC
paaA	paaA
paaB	paaB
paaC	paaC
paaD	paaD
paaE	paaE
paaF	paaF
paaG	paaG
paaH	paaH
paaI	paaI
paaJ	paaJ
paaK	paaK
paaX	paaX
paaY	paaY
ydbA_1	ydbA_1
ydbA_2	ydbA_2
ydbC	ydbC
ydbD	ydbD
ynbA	ynbA
ynbB	ynbB
ynbC	ynbC
ynbD	ynbD
azoR	azoR
hrpA	hrpA
ydcF	ydcF
aldA	aldA
gapC_2	gapC_2
gapC_1	gapC_1
gapC	gapC
cybB	cybB
ydcA	ydcA
hokB	hokB
mokB	mokB
trg	trg
ydcI	ydcI
ydcJ	ydcJ
mdoD	mdoD
ydcH	ydcH
rimL	rimL
ydcK	ydcK
tehA	tehA
tehB	tehB
ydcL	ydcL
yncK_1	yncK_1
yncK_2	yncK_2
yncK	yncK
ydcM	ydcM
ydcO	ydcO
ydcN	ydcN
ydcP	ydcP
yncJ	yncJ
yncN	yncN
ydcQ	ydcQ
ydcR	ydcR
ydcS	ydcS
ydcT	ydcT
ydcU	ydcU
ydcV	ydcV
ydcW	ydcW
ydcX	ydcX
ydcY	ydcY
ydcZ	ydcZ
yncA	yncA
yncB	yncB
yncC	yncC
yncD	yncD
yncE	yncE
ansP	ansP
yncG	yncG
yncH	yncH
rhsE	rhsE
ydcD	ydcD
yncI	yncI
yncM	yncM
ydcC	ydcC
ydcE	ydcE
yddH	yddH
nhoA	nhoA
yddE	yddE
narV	narV
narW	narW
narY	narY
narZ	narZ
narU	narU
yddJ	yddJ
yddK	yddK
yddL	yddL
yddG	yddG
fdnG	fdnG
fdnH	fdnH
fdnI	fdnI
yddM	yddM
adhP	adhP
sfcA	sfcA
sra	sra
bdm	bdm
osmC	osmC
ddpF	ddpF
ddpD	ddpD
ddpC	ddpC
ddpB	ddpB
ddpA	ddpA
ddpX	ddpX
dos	dos
yddV	yddV
yddW	yddW
gadC	gadC
gadB	gadB
pqqL	pqqL
yddB	yddB
yddA	yddA
ydeM	ydeM
ydeN	ydeN
ydeO	ydeO
ydeP	ydeP
ydeQ	ydeQ
ydeR	ydeR
ydeS	ydeS
ydeT	ydeT
yneL	yneL
hipA	hipA
hipB	hipB
ydeU	ydeU
ydeK	ydeK
ydeV	ydeV
ydeW	ydeW
ego	ego
lsrC	lsrC
lsrD	lsrD
lsrB	lsrB
lsrF	lsrF
lsrG	lsrG
tam	tam
yneE	yneE
uxaB	uxaB
yneF	yneF
yneG	yneG
yneH	yneH
yneI	yneI
yneJ	yneJ
yneK	yneK
ydeA	ydeA
marC	marC
marR	marR
marA	marA
marB	marB
eamA	eamA
ydeE	ydeE
ydeH	ydeH
ydeI	ydeI
ydeJ	ydeJ
dcp	dcp
ydfG	ydfG
ydfH	ydfH
ydfZ	ydfZ
ydfI	ydfI
ydfJ	ydfJ
ydfK	ydfK
pinQ	pinQ
tfaQ	tfaQ
stfQ	stfQ
nohA	nohA
ynfO	ynfO
ydfO	ydfO
gnsB	gnsB
ynfN	ynfN
cspI	cspI
ydfP	ydfP
ydfQ	ydfQ
ydfR	ydfR
essQ	essQ
cspB	cspB
cspF	cspF
ydfT	ydfT
ydfU	ydfU
rem	rem
hokD	hokD
relE	relE
relB	relB
ydfV	ydfV
flxA	flxA
ydfW	ydfW
ydfX	ydfX
dicC	dicC
dicA	dicA
ydfA	ydfA
ydfB	ydfB
ydfC	ydfC
dicB	dicB
ydfD	ydfD
ydfE	ydfE
insD-7	insD-7
intQ	intQ
ynfP	ynfP
rspB	rspB
rspA	rspA
ynfA	ynfA
ynfB	ynfB
speG	speG
ynfC	ynfC
ynfD	ynfD
ynfE	ynfE
ynfF	ynfF
ynfG	ynfG
ynfH	ynfH
dmsD	dmsD
clcB	clcB
ynfK	ynfK
dgsA	dgsA
ynfL	ynfL
ynfM	ynfM
asr	asr
ydgD	ydgD
mdtI	mdtI
mdtJ	mdtJ
ydgG	ydgG
pntB	pntB
pntA	pntA
ydgH	ydgH
ydgI	ydgI
folM	folM
ydgC	ydgC
rstA	rstA
rstB	rstB
tus	tus
fumC	fumC
fumA	fumA
manA	manA
ydgA	ydgA
uidC	uidC
uidB	uidB
uidA	uidA
uidR	uidR
hdhA	hdhA
malI	malI
malX	malX
malY	malY
add	add
ydgJ	ydgJ
blr	blr
ydgT	ydgT
ydgK	ydgK
rsxA	rsxA
rsxB	rsxB
rsxC	rsxC
rsxD	rsxD
rsxG	rsxG
rsxE	rsxE
nth	nth
ydgR	ydgR
gst	gst
pdxY	pdxY
tyrS	tyrS
pdxH	pdxH
ydhA	ydhA
ydhH	ydhH
slyB	slyB
slyA	slyA
ydhI	ydhI
ydhJ	ydhJ
ydhK	ydhK
sodC	sodC
ydhF	ydhF
ydhL	ydhL
ydhM	ydhM
nemA	nemA
gloA	gloA
rnt	rnt
lhr	lhr
ydhD	ydhD
ydhO	ydhO
sodB	sodB
ydhP	ydhP
purR	purR
ydhB	ydhB
ydhC	ydhC
cfa	cfa
ribC	ribC
mdtK	mdtK
ydhQ	ydhQ
valV	valV
valW	valW
ydhR	ydhR
ydhS	ydhS
ydhT	ydhT
ydhU	ydhU
ydhX	ydhX
ydhW	ydhW
ydhV	ydhV
ydhY	ydhY
ydhZ	ydhZ
pykF	pykF
lpp	lpp
ynhG	ynhG
sufE	sufE
sufS	sufS
sufD	sufD
sufC	sufC
sufB	sufB
sufA	sufA
rydB	rydB
ydiH	ydiH
ydiI	ydiI
ydiJ	ydiJ
ydiK	ydiK
rprA	rprA
ydiL	ydiL
ydiM	ydiM
ydiN	ydiN
ydiB	ydiB
aroD	aroD
ydiF	ydiF
ydiO	ydiO
ydiP	ydiP
ydiQ	ydiQ
ydiR	ydiR
ydiS	ydiS
ydiT	ydiT
ydiD	ydiD
pps	pps
ydiA	ydiA
aroH	aroH
ydiE	ydiE
ydiU	ydiU
ydiV	ydiV
nlpC	nlpC
btuD	btuD
btuE	btuE
btuC	btuC
ihfA	ihfA
pheT	pheT
pheS	pheS
rplT	rplT
rpmI	rpmI
infC	infC
thrS	thrS
arpB_1	arpB_1
arpB_2	arpB_2
arpB	arpB
yniD	yniD
ydiY	ydiY
pfkB	pfkB
ydiZ	ydiZ
yniA	yniA
yniB	yniB
yniC	yniC
ydjM	ydjM
ydjN	ydjN
ydjO	ydjO
cedA	cedA
katE	katE
chbG	chbG
chbF	chbF
chbR	chbR
chbA	chbA
chbC	chbC
chbB	chbB
osmE	osmE
nadE	nadE
ydjQ	ydjQ
ydjR	ydjR
spy	spy
astE	astE
astB	astB
astD	astD
astA	astA
astC	astC
xthA	xthA
ydjX	ydjX
ydjY	ydjY
ydjZ	ydjZ
ynjA	ynjA
ynjB	ynjB
ynjC	ynjC
ynjD	ynjD
ynjE	ynjE
ynjF	ynjF
nudG	nudG
ynjH	ynjH
gdhA	gdhA
ynjI	ynjI
topB	topB
selD	selD
ydjA	ydjA
sppA	sppA
ansA	ansA
pncA	pncA
ydjE	ydjE
ydjF	ydjF
ydjG	ydjG
ydjH	ydjH
ydjI	ydjI
ydjJ	ydjJ
ydjK	ydjK
ydjL	ydjL
yeaC	yeaC
yeaA	yeaA
gapA	gapA
yeaD	yeaD
yeaE	yeaE
mipA	mipA
yeaG	yeaG
yeaH	yeaH
yeaI	yeaI
yeaJ	yeaJ
yeaK	yeaK
yoaI	yoaI
yeaL	yeaL
yeaM	yeaM
yeaN	yeaN
yeaO	yeaO
yoaF	yoaF
yeaP	yeaP
yeaQ	yeaQ
yoaG	yoaG
yeaR	yeaR
yeaS	yeaS
yeaT	yeaT
yeaU	yeaU
yeaV	yeaV
yeaW	yeaW
yeaX	yeaX
rnd	rnd
fadD	fadD
yeaY	yeaY
yeaZ	yeaZ
yoaA	yoaA
yoaB	yoaB
yoaC	yoaC
yoaH	yoaH
pabB	pabB
yeaB	yeaB
sdaA	sdaA
yoaD	yoaD
yoaE	yoaE
manX	manX
manY	manY
manZ	manZ
yobD	yobD
yebN	yebN
rrmA	rrmA
cspC	cspC
yobF	yobF
yebO	yebO
yobG	yobG
yobH	yobH
kdgR	kdgR
yebQ	yebQ
htpX	htpX
prc	prc
proQ	proQ
yebR	yebR
yebS	yebS
yebT	yebT
yebU	yebU
yebV	yebV
yebW	yebW
pphA	pphA
ryeA	ryeA
ryeB	ryeB
yebY	yebY
yebZ	yebZ
yobA	yobA
holE	holE
yobB	yobB
exoX	exoX
ptrB	ptrB
yebE	yebE
yebF	yebF
yebG	yebG
purT	purT
eda	eda
edd	edd
zwf	zwf
yebK	yebK
pykA	pykA
lpxM	lpxM
yebA	yebA
znuA	znuA
znuC	znuC
znuB	znuB
ruvB	ruvB
ruvA	ruvA
yebB	yebB
ruvC	ruvC
yebC	yebC
nudB	nudB
aspS	aspS
yecD	yecD
yecE	yecE
yecN	yecN
yecO	yecO
yecP	yecP
torZ	torZ
torY	torY
cutC	cutC
yecM	yecM
argS	argS
yecT	yecT
flhE	flhE
flhA	flhA
flhB	flhB
cheZ	cheZ
cheY	cheY
cheB	cheB
cheR	cheR
tap	tap
tar	tar
cheW	cheW
cheA	cheA
motB	motB
motA	motA
flhC	flhC
flhD	flhD
yecG	yecG
otsA	otsA
otsB	otsB
araH	araH
araG	araG
araF	araF
yecI	yecI
yecJ	yecJ
IS092	IS092
yecR	yecR
ftn	ftn
yecH	yecH
tyrP	tyrP
yecA	yecA
leuZ	leuZ
cysT	cysT
glyW	glyW
pgsA	pgsA
uvrC	uvrC
uvrY	uvrY
yecF	yecF
sdiA	sdiA
yecC	yecC
yecS	yecS
yedO	yedO
fliY	fliY
fliZ	fliZ
fliA	fliA
fliC	fliC
fliD	fliD
fliS	fliS
fliT	fliT
amyA	amyA
yedD	yedD
yedE	yedE
yedF	yedF
yedK	yedK
yedL	yedL
yedN_2	yedN_2
yedN_1	yedN_1
yedN	yedN
yedM	yedM
intG	intG
fliE	fliE
fliF	fliF
fliG	fliG
fliH	fliH
fliI	fliI
fliJ	fliJ
fliK	fliK
fliL	fliL
fliM	fliM
fliN	fliN
fliO	fliO
fliP	fliP
fliQ	fliQ
fliR	fliR
rcsA	rcsA
dsrB	dsrB
yodD	yodD
dsrA	dsrA
yedP	yedP
yedQ	yedQ
yodC	yodC
yedI	yedI
yedA	yedA
vsr	vsr
dcm	dcm
yedJ	yedJ
yedR	yedR
yedS_1	yedS_1
yedS_2	yedS_2
yedS_3	yedS_3
yedS	yedS
hchA	hchA
yedV	yedV
yedW	yedW
yedX	yedX
yedY	yedY
yedZ	yedZ
yodA	yodA
yodB	yodB
serU	serU
yeeI	yeeI
asnT	asnT
yeeJ	yeeJ
yeeL_2	yeeL_2
yeeL_1	yeeL_1
yeeL	yeeL
shiA	shiA
amn	amn
yeeN	yeeN
asnW	asnW
yeeO	yeeO
asnU	asnU
cbl	cbl
nac	nac
asnV	asnV
erfK	erfK
cobT	cobT
cobS	cobS
cobU	cobU
yoeA	yoeA
yoeE	yoeE
yeeP	yeeP
IS102	IS102
flu	flu
yeeR	yeeR
yeeS	yeeS
yeeT	yeeT
yeeU	yeeU
yeeV	yeeV
yeeW	yeeW
yoeF	yoeF
yeeX	yeeX
yeeA	yeeA
sbmC	sbmC
dacD	dacD
sbcB	sbcB
yeeD	yeeD
yeeE	yeeE
yeeF	yeeF
yeeY	yeeY
yeeZ	yeeZ
yoeB	yoeB
yefM	yefM
hisG	hisG
hisD	hisD
hisC	hisC
hisB	hisB
hisH	hisH
hisA	hisA
hisF	hisF
hisI	hisI
cld	cld
ugd	ugd
gnd	gnd
wbbL_1	wbbL_1
wbbL_2	wbbL_2
wbbL	wbbL
wbbK	wbbK
wbbJ	wbbJ
wbbI	wbbI
wbbH	wbbH
glf	glf
rfbX	rfbX
rfbC	rfbC
rfbA	rfbA
rfbD	rfbD
rfbB	rfbB
galF	galF
wcaM	wcaM
wcaL	wcaL
wcaK	wcaK
wzxC	wzxC
wcaJ	wcaJ
cpsG	cpsG
cpsB	cpsB
wcaI	wcaI
nudD	nudD
fcl	fcl
gmd	gmd
wcaF	wcaF
wcaE	wcaE
wcaD	wcaD
wcaC	wcaC
wcaB	wcaB
wcaA	wcaA
wzc	wzc
wzb	wzb
wza	wza
yegH	yegH
asmA	asmA
dcd	dcd
udk	udk
yegE	yegE
alkA	alkA
yegD	yegD
yegI	yegI
yegJ	yegJ
yegK	yegK
yegL	yegL
ryeC	ryeC
ryeD	ryeD
mdtA	mdtA
mdtB	mdtB
mdtC	mdtC
mdtD	mdtD
baeS	baeS
baeR	baeR
yegP	yegP
yegQ	yegQ
ryeE	ryeE
ogrK	ogrK
yegZ	yegZ
yegR	yegR
yegS	yegS
gatR_1	gatR_1
gatR_2	gatR_2
gatR	gatR
gatD	gatD
gatC	gatC
gatB	gatB
gatA	gatA
gatZ	gatZ
gatY	gatY
fbaB	fbaB
yegT	yegT
yegU	yegU
yegV	yegV
yegW	yegW
yegX	yegX
thiD	thiD
thiM	thiM
yohL	yohL
yohM	yohM
yohN	yohN
yehA	yehA
yehB	yehB
yehC	yehC
yehD	yehD
yehE	yehE
mrp	mrp
metG	metG
molR_1	molR_1
molR_2	molR_2
molR_3	molR_3
molR	molR
yehI	yehI
yehK	yehK
yehL	yehL
yehM	yehM
yehP	yehP
yehQ	yehQ
yehR	yehR
yehS	yehS
yehT	yehT
yehU	yehU
mlrA	mlrA
yohO	yohO
yehW	yehW
yehX	yehX
yehY	yehY
yehZ	yehZ
bglX	bglX
dld	dld
pbpG	pbpG
yohC	yohC
yohD	yohD
yohF	yohF
yohG	yohG
yohH	yohH
dusC	dusC
yohJ	yohJ
yohK	yohK
cdd	cdd
sanA	sanA
yeiS	yeiS
yeiT	yeiT
yeiA	yeiA
mglC	mglC
mglA	mglA
mglB	mglB
galS	galS
yeiB	yeiB
folE	folE
yeiG	yeiG
cirA	cirA
lysP	lysP
yeiE	yeiE
yeiH	yeiH
nfo	nfo
yeiI	yeiI
yeiJ	yeiJ
rihB	rihB
yeiL	yeiL
yeiM	yeiM
yeiN	yeiN
yeiC	yeiC
fruA	fruA
fruK	fruK
fruB	fruB
setB	setB
yeiW	yeiW
yeiP	yeiP
yeiQ	yeiQ
yeiR	yeiR
yeiU	yeiU
spr	spr
rtn	rtn
yejA	yejA
yejB	yejB
yejE	yejE
yejF	yejF
yejG	yejG
bcr	bcr
rsuA	rsuA
yejH	yejH
rplY	rplY
yejK	yejK
yejL	yejL
yejM	yejM
proL	proL
yejO	yejO
narP	narP
ccmH	ccmH
ccmG	ccmG
ccmF	ccmF
ccmE	ccmE
ccmD	ccmD
ccmC	ccmC
ccmB	ccmB
ccmA	ccmA
napC	napC
napB	napB
napH	napH
napG	napG
napA	napA
napD	napD
napF	napF
eco	eco
mqo	mqo
yojI	yojI
alkB	alkB
ada	ada
yojL	yojL
ompC	ompC
micF	micF
rcsD	rcsD
rcsB	rcsB
rcsC	rcsC
atoS	atoS
atoC	atoC
atoD	atoD
atoA	atoA
atoE	atoE
atoB	atoB
yfaP	yfaP
yfaQ	yfaQ
yfaS_2	yfaS_2
yfaS_1	yfaS_1
yfaS	yfaS
yfaT	yfaT
yfaA	yfaA
gyrA	gyrA
ubiG	ubiG
yfaL	yfaL
nrdA	nrdA
nrdB	nrdB
yfaE	yfaE
inaA	inaA
yfaH	yfaH
glpQ	glpQ
glpT	glpT
glpA	glpA
glpB	glpB
glpC	glpC
yfaD	yfaD
ypaA	ypaA
yfaU	yfaU
yfaV	yfaV
yfaW	yfaW
yfaX	yfaX
yfaY	yfaY
yfaZ	yfaZ
yfaO	yfaO
ais	ais
yfbE	yfbE
yfbF	yfbF
yfbG	yfbG
yfbH	yfbH
arnT	arnT
yfbW	yfbW
yfbJ	yfbJ
pmrD	pmrD
menE	menE
menC	menC
menB	menB
yfbB	yfbB
menD	menD
menF	menF
elaB	elaB
elaA	elaA
elaC	elaC
elaD	elaD
yfbK	yfbK
yfbL	yfbL
yfbM	yfbM
yfbN	yfbN
yfbO	yfbO
yfbP	yfbP
nuoN	nuoN
nuoM	nuoM
nuoL	nuoL
nuoK	nuoK
nuoJ	nuoJ
nuoI	nuoI
nuoH	nuoH
nuoG	nuoG
nuoF	nuoF
nuoE	nuoE
nuoC	nuoC
nuoB	nuoB
nuoA	nuoA
lrhA	lrhA
yfbQ	yfbQ
yfbR	yfbR
yfbS	yfbS
yfbT	yfbT
yfbU	yfbU
yfbV	yfbV
ackA	ackA
pta	pta
yfcC	yfcC
yfcD	yfcD
yfcE	yfcE
yfcF	yfcF
yfcG	yfcG
folX	folX
yfcH	yfcH
yfcI	yfcI
hisP	hisP
hisM	hisM
hisQ	hisQ
hisJ	hisJ
argT	argT
ubiX	ubiX
purF	purF
cvpA	cvpA
dedD	dedD
folC	folC
accD	accD
dedA	dedA
truA	truA
usg	usg
pdxB	pdxB
flk	flk
yfcJ	yfcJ
fabB	fabB
trmC	trmC
yfcL	yfcL
yfcM	yfcM
yfcA	yfcA
mepA	mepA
aroC	aroC
prmB	prmB
yfcN	yfcN
yfcO	yfcO
yfcP	yfcP
yfcQ	yfcQ
yfcR	yfcR
yfcS	yfcS
yfcT	yfcT
yfcU	yfcU
yfcV	yfcV
sixA	sixA
yfcX	yfcX
yfcY	yfcY
yfcZ	yfcZ
fadL	fadL
yfdF	yfdF
vacJ	vacJ
yfdC	yfdC
argW	argW
intS	intS
yfdG	yfdG
yfdH	yfdH
yfdI	yfdI
tfaS	tfaS
yfdK	yfdK
yfdL	yfdL
yfdM	yfdM
yfdN	yfdN
yfdO	yfdO
yfdP	yfdP
yfdQ	yfdQ
yfdR	yfdR
yfdS	yfdS
yfdT	yfdT
ypdJ	ypdJ
torI	torI
dsdC	dsdC
dsdX	dsdX
dsdA	dsdA
emrY	emrY
emrK	emrK
evgA	evgA
evgS	evgS
yfdE	yfdE
yfdV	yfdV
oxc	oxc
frc	frc
yfdX	yfdX
ypdI	ypdI
yfdY	yfdY
ddg	ddg
yfdZ	yfdZ
ypdA	ypdA
ypdB	ypdB
ypdC	ypdC
ypdD	ypdD
ypdE	ypdE
ypdF	ypdF
ypdG	ypdG
ypdH	ypdH
glk	glk
yfeO	yfeO
ypeC	ypeC
mntH	mntH
nupC	nupC
yfeA	yfeA
alaX	alaX
alaW	alaW
yfeC	yfeC
yfeD	yfeD
gltX	gltX
valU	valU
valX	valX
valY	valY
lysV	lysV
xapR	xapR
xapB	xapB
xapA	xapA
yfeN	yfeN
yfeR	yfeR
yfeH	yfeH
ypeB	ypeB
ligA	ligA
zipA	zipA
cysZ	cysZ
cysK	cysK
ptsH	ptsH
ptsI	ptsI
crr	crr
pdxK	pdxK
yfeK	yfeK
yfeS	yfeS
cysM	cysM
cysA	cysA
cysW	cysW
cysU	cysU
cysP	cysP
ucpA	ucpA
yfeT	yfeT
yfeU	yfeU
murP	murP
yfeW	yfeW
yfeX	yfeX
yfeY	yfeY
yfeZ	yfeZ
ypeA	ypeA
amiA	amiA
hemF	hemF
yfeG	yfeG
yffI	yffI
eutL	eutL
eutC	eutC
eutB	eutB
eutA	eutA
eutH	eutH
eutG	eutG
eutJ	eutJ
eutE	eutE
cchB	cchB
cchA	cchA
eutI	eutI
eutT	eutT
eutQ	eutQ
eutP	eutP
ypfE	ypfE
maeB	maeB
talA	talA
tktB	tktB
ypfG	ypfG
yffH	yffH
aegA	aegA
narQ	narQ
acrD	acrD
yffB	yffB
dapE	dapE
ypfN	ypfN
ypfH	ypfH
ypfI	ypfI
ypfJ	ypfJ
purC	purC
nlpB	nlpB
dapA	dapA
gcvR	gcvR
bcp	bcp
hyfA	hyfA
hyfB	hyfB
hyfC	hyfC
hyfD	hyfD
hyfE	hyfE
hyfF	hyfF
hyfG	hyfG
hyfH	hyfH
hyfI	hyfI
hyfJ	hyfJ
hyfR	hyfR
focB	focB
yfgO	yfgO
yfgC	yfgC
yfgD	yfgD
hda	hda
uraA	uraA
upp	upp
purM	purM
purN	purN
ppk	ppk
ppx	ppx
yfgF	yfgF
yfgG	yfgG
yfgH	yfgH
yfgI	yfgI
guaA	guaA
guaB	guaB
xseA	xseA
yfgJ	yfgJ
der	der
yfgL	yfgL
yfgM	yfgM
hisS	hisS
ispG	ispG
yfgA	yfgA
yfgB	yfgB
ndk	ndk
pbpC	pbpC
yfhM	yfhM
sseA	sseA
ryfA	ryfA
sseB	sseB
pepB	pepB
yfhJ	yfhJ
fdx	fdx
hscA	hscA
hscB	hscB
iscA	iscA
iscU	iscU
iscS	iscS
iscR	iscR
yfhQ	yfhQ
suhB	suhB
yfhR	yfhR
csiE	csiE
hcaT	hcaT
hcaR	hcaR
hcaE	hcaE
hcaF	hcaF
hcaC	hcaC
hcaB	hcaB
hcaD	hcaD
yphA	yphA
yphB	yphB
yphC	yphC
yphD	yphD
yphE	yphE
yphF	yphF
yphG	yphG
yphH	yphH
glyA	glyA
hmp	hmp
glnB	glnB
yfhA	yfhA
yfhG	yfhG
yfhK	yfhK
tke1	tke1
purL	purL
yfhD	yfhD
tadA	tadA
yfhB	yfhB
yfhH	yfhH
yfhL	yfhL
acpS	acpS
pdxJ	pdxJ
recO	recO
era	era
rnc	rnc
lepB	lepB
lepA	lepA
rseC	rseC
rseB	rseB
rseA	rseA
rpoE	rpoE
nadB	nadB
yfiC	yfiC
srmB	srmB
yfiE	yfiE
yfiK	yfiK
yfiD	yfiD
ung	ung
yfiF	yfiF
trxC	trxC
yfiP	yfiP
yfiQ	yfiQ
pssA	pssA
yfiM	yfiM
kgtP	kgtP
rrfG	rrfG
rrlG	rrlG
gltW	gltW
rrsG	rrsG
clpB	clpB
yfiH	yfiH
rluD	rluD
yfiO	yfiO
yfiA	yfiA
pheA	pheA
tyrA	tyrA
aroF	aroF
yfiL	yfiL
yfiR	yfiR
yfiN	yfiN
yfiB	yfiB
rplS	rplS
trmD	trmD
rimM	rimM
rpsP	rpsP
ffh	ffh
ypjD	ypjD
yfjD	yfjD
grpE	grpE
yfjB	yfjB
recN	recN
smpA	smpA
yfjF	yfjF
yfjG	yfjG
smpB	smpB
ssrA	ssrA
intA	intA
yfjH	yfjH
alpA	alpA
yfjI	yfjI
yfjJ	yfjJ
yfjK	yfjK
yfjL	yfjL
yfjM	yfjM
yfjN	yfjN
yfjO	yfjO
yfjP	yfjP
yfjQ	yfjQ
yfjR	yfjR
ypjK	ypjK
yfjS	yfjS
yfjT	yfjT
yfjU	yfjU
ypjL	ypjL
yfjV	yfjV
ypjM	ypjM
yfjW	yfjW
yfjX	yfjX
yfjY	yfjY
ypjJ	ypjJ
yfjZ	yfjZ
ypjF	ypjF
ypjA	ypjA
pinH	pinH
ypjB	ypjB
ypjC	ypjC
ileY	ileY
ygaQ	ygaQ
ygaR	ygaR
yqaC	yqaC
yqaD	yqaD
ygaT	ygaT
ygaF	ygaF
gabD	gabD
gabT	gabT
gabP	gabP
csiR	csiR
ygaU	ygaU
yqaE	yqaE
ygaV	ygaV
ygaP	ygaP
stpA	stpA
ygaW	ygaW
ygaC	ygaC
ygaM	ygaM
nrdH	nrdH
nrdI	nrdI
nrdE	nrdE
nrdF	nrdF
proV	proV
proW	proW
proX	proX
ygaX	ygaX
ygaY	ygaY
ygaZ	ygaZ
ygaH	ygaH
mprA	mprA
emrA	emrA
emrB	emrB
luxS	luxS
sraD	sraD
gshA	gshA
yqaA	yqaA
yqaB	yqaB
argQ	argQ
argZ	argZ
argY	argY
argV	argV
serV	serV
csrA	csrA
alaS	alaS
recX	recX
recA	recA
ygaD	ygaD
mltB	mltB
srlA	srlA
srlE	srlE
srlB	srlB
srlD	srlD
gutM	gutM
srlR	srlR
gutQ	gutQ
norR	norR
norV	norV
norW	norW
hypF	hypF
hydN	hydN
ascG	ascG
ascF	ascF
ascB	ascB
hycI	hycI
hycH	hycH
hycG	hycG
hycF	hycF
hycE	hycE
hycD	hycD
hycC	hycC
hycB	hycB
hycA	hycA
hypA	hypA
hypB	hypB
hypC	hypC
hypD	hypD
hypE	hypE
fhlA	fhlA
ygbA	ygbA
mutS	mutS
pphB	pphB
ygbI	ygbI
ygbJ	ygbJ
ygbK	ygbK
ygbL	ygbL
ygbM	ygbM
ygbN	ygbN
rpoS	rpoS
nlpD	nlpD
pcm	pcm
surE	surE
truD	truD
ispF	ispF
ispD	ispD
ftsB	ftsB
ygbE	ygbE
cysC	cysC
cysN	cysN
cysD	cysD
iap	iap
ygbF	ygbF
ygbT	ygbT
ygcH	ygcH
ygcI	ygcI
ygcJ	ygcJ
ygcK	ygcK
ygcL	ygcL
ygcB	ygcB
cysH	cysH
cysI	cysI
cysJ	cysJ
ygcM	ygcM
ygcN	ygcN
ygcO	ygcO
ygcP	ygcP
ygcQ	ygcQ
ygcR	ygcR
ygcS	ygcS
ygcU	ygcU
ygcW	ygcW
yqcE	yqcE
ygcE	ygcE
ygcF	ygcF
ygcG	ygcG
eno	eno
pyrG	pyrG
mazG	mazG
chpA	chpA
chpR	chpR
relA	relA
rumA	rumA
barA	barA
gudD	gudD
gudX	gudX
gudP	gudP
yqcA	yqcA
yqcB	yqcB
yqcC	yqcC
csrB	csrB
syd	syd
yqcD	yqcD
ygdH	ygdH
sdaC	sdaC
sdaB	sdaB
exo	exo
fucO	fucO
fucA	fucA
fucP	fucP
fucI	fucI
fucK	fucK
fucU	fucU
fucR	fucR
ygdE	ygdE
ygdD	ygdD
gcvA	gcvA
gcvB	gcvB
ygdI	ygdI
csdA	csdA
ygdK	ygdK
ygdL	ygdL
mltA	mltA
metZ	metZ
metW	metW
metV	metV
amiC	amiC
argA	argA
recD	recD
recB	recB
ptr	ptr
recC	recC
ppdC	ppdC
ygdB	ygdB
ppdB	ppdB
ppdA	ppdA
thyA	thyA
lgt	lgt
ptsP	ptsP
nudH	nudH
mutH	mutH
ygdQ	ygdQ
ygdR	ygdR
tas	tas
ygeD	ygeD
aas	aas
rygA	rygA
rygB	rygB
galR	galR
lysA	lysA
lysR	lysR
ygeA	ygeA
araE	araE
kduD	kduD
kduI	kduI
yqeF	yqeF
yqeG	yqeG
yqeH	yqeH
yqeI	yqeI
yqeJ	yqeJ
yqeK	yqeK
ygeF	ygeF
ygeG	ygeG
ygeH	ygeH
ygeI	ygeI
pbl	pbl
ygeK	ygeK
ygeL	ygeL
ygeM	ygeM
ygeN	ygeN
ygeO	ygeO
ygeP	ygeP
ygeQ	ygeQ
glyU	glyU
ygeR	ygeR
xdhA	xdhA
xdhB	xdhB
xdhC	xdhC
ygeV	ygeV
ygeW	ygeW
ygeX	ygeX
ygeY	ygeY
hyuA	hyuA
yqeA	yqeA
yqeB	yqeB
yqeC	yqeC
ygfJ	ygfJ
ygfK	ygfK
ssnA	ssnA
ygfM	ygfM
xdhD	xdhD
ygfO	ygfO
guaD	guaD
ygfQ	ygfQ
ygfS	ygfS
ygfT	ygfT
ygfU	ygfU
idi	idi
lysS	lysS
prfB	prfB
recJ	recJ
dsbC	dsbC
xerD	xerD
fldB	fldB
ygfX	ygfX
ygfY	ygfY
ygfZ	ygfZ
yqfA	yqfA
yqfB	yqfB
bglA	bglA
ygfF	ygfF
gcvP	gcvP
gcvH	gcvH
gcvT	gcvT
visC	visC
ubiH	ubiH
pepP	pepP
ygfB	ygfB
zapA	zapA
ssrS	ssrS
ygfA	ygfA
rygC	rygC
serA	serA
rpiA	rpiA
yqfE	yqfE
argP	argP
yliK	yliK
argK	argK
ygfG	ygfG
ygfH	ygfH
ygfI	ygfI
yggE	yggE
argO	argO
mscS	mscS
fbaA	fbaA
pgk	pgk
epd	epd
yggC	yggC
yggD	yggD
yggF	yggF
yggP	yggP
cmtA	cmtA
cmtB	cmtB
tktA	tktA
yggG	yggG
speB	speB
speA	speA
yqgB	yqgB
yqgC	yqgC
yqgD	yqgD
metK	metK
galP	galP
sprT	sprT
endA	endA
yggJ	yggJ
gshB	gshB
yqgE	yqgE
yqgF	yqgF
yggR	yggR
yggS	yggS
yggT	yggT
yggU	yggU
yggV	yggV
yggW	yggW
yggM	yggM
ansB	ansB
yggN	yggN
yggL	yggL
yggH	yggH
mutY	mutY
yggX	yggX
mltC	mltC
nupG	nupG
speC	speC
yqgA	yqgA
pheV	pheV
yghD	yghD
yghE	yghE
yghF	yghF
yghG	yghG
pppA	pppA
yghJ	yghJ
yghK	yghK
glcB	glcB
glcG	glcG
glcF	glcF
glcE	glcE
glcD	glcD
glcC	glcC
yghO	yghO
yghQ	yghQ
yghR	yghR
yghS	yghS
yghT	yghT
pitB	pitB
gss	gss
yghU	yghU
hybG	hybG
hybF	hybF
hybE	hybE
hybD	hybD
hybC	hybC
hybB	hybB
hybA	hybA
hybO	hybO
yghW	yghW
yghX	yghX
yghY	yghY
yghZ	yghZ
yqhA	yqhA
yghA	yghA
exbD	exbD
exbB	exbB
metC	metC
yghB	yghB
yqhC	yqhC
yqhD	yqhD
dkgA	dkgA
yqhG	yqhG
yqhH	yqhH
ygiQ	ygiQ
sufI	sufI
plsC	plsC
parC	parC
ygiS	ygiS
ygiT	ygiT
ygiU	ygiU
ygiV	ygiV
ygiW	ygiW
qseB	qseB
qseC	qseC
ygiZ	ygiZ
mdaB	mdaB
ygiN	ygiN
parE	parE
yqiA	yqiA
cpdA	cpdA
yqiB	yqiB
nudF	nudF
tolC	tolC
ygiA	ygiA
ygiB	ygiB
ygiC	ygiC
zupT	zupT
ygiE	ygiE
ribB	ribB
yqiC	yqiC
ygiL	ygiL
yqiG	yqiG
yqiH	yqiH
yqiI	yqiI
glgS	glgS
yqiJ	yqiJ
yqiK	yqiK
rygD	rygD
rfaE	rfaE
glnE	glnE
ygiF	ygiF
htrG	htrG
cca	cca
bacA	bacA
folB	folB
ygiH	ygiH
ygiP	ygiP
ttdA	ttdA
ttdB	ttdB
ygjE	ygjE
ygjD	ygjD
rpsU	rpsU
dnaG	dnaG
rpoD	rpoD
ygjF	ygjF
ileX	ileX
yqjH	yqjH
yqjI	yqjI
aer	aer
ygjG	ygjG
ygjH	ygjH
ebgR	ebgR
ebgA	ebgA
ebgC	ebgC
ygjI	ygjI
ygjJ	ygjJ
ygjK	ygjK
fadH	fadH
ygjM	ygjM
ygjN	ygjN
ygjO	ygjO
ygjP	ygjP
ygjQ	ygjQ
ygjR	ygjR
sraF	sraF
alx	alx
sstT	sstT
ygjV	ygjV
uxaA	uxaA
uxaC	uxaC
exuT	exuT
exuR	exuR
yqjA	yqjA
yqjB	yqjB
yqjC	yqjC
yqjD	yqjD
yqjE	yqjE
yqjK	yqjK
yqjF	yqjF
yqjG	yqjG
yhaH	yhaH
yhaI	yhaI
yhaJ	yhaJ
yhaK	yhaK
yhaL	yhaL
yhaM	yhaM
yhaO	yhaO
tdcG	tdcG
tdcF	tdcF
tdcE	tdcE
tdcD	tdcD
tdcC	tdcC
tdcB	tdcB
tdcA	tdcA
tdcR	tdcR
yhaB	yhaB
yhaC	yhaC
rnpB	rnpB
garK	garK
garR	garR
garL	garL
garP	garP
garD	garD
sohA	sohA
yhaV	yhaV
agaR	agaR
kbaZ	kbaZ
agaV	agaV
agaW	agaW
agaA	agaA
agaS	agaS
kbaY	kbaY
agaB	agaB
agaC	agaC
agaD	agaD
agaI	agaI
yraH	yraH
yraI	yraI
yraJ	yraJ
yraK	yraK
yraL	yraL
yraM	yraM
yraN	yraN
yraO	yraO
yraP	yraP
yraQ	yraQ
yraR	yraR
yhbO	yhbO
yhbP	yhbP
yhbQ	yhbQ
yhbS	yhbS
yhbT	yhbT
yhbU	yhbU
yhbV	yhbV
yhbW	yhbW
mtr	mtr
deaD	deaD
nlpI	nlpI
pnp	pnp
sraG	sraG
rpsO	rpsO
truB	truB
rbfA	rbfA
infB	infB
nusA	nusA
yhbC	yhbC
metY	metY
argG	argG
yhbX	yhbX
leuU	leuU
secG	secG
glmM	glmM
folP	folP
ftsH	ftsH
rrmJ	rrmJ
yhbY	yhbY
greA	greA
dacB	dacB
obgE	obgE
yhbE	yhbE
rpmA	rpmA
rplU	rplU
ispB	ispB
sfsB	sfsB
murA	murA
yrbA	yrbA
yrbB	yrbB
yrbC	yrbC
yrbD	yrbD
yrbE	yrbE
yrbF	yrbF
yrbG	yrbG
kdsD	kdsD
kdsC	kdsC
yrbK	yrbK
yhbN	yhbN
yhbG	yhbG
rpoN	rpoN
yhbH	yhbH
ptsN	ptsN
yhbJ	yhbJ
npr	npr
yrbL	yrbL
mtgA	mtgA
elbB	elbB
ryhA	ryhA
arcB	arcB
yhcC	yhcC
gltB	gltB
gltD	gltD
gltF	gltF
yhcA	yhcA
yhcD	yhcD
yhcE_1	yhcE_1
yhcE_2	yhcE_2
yhcE	yhcE
yhcF	yhcF
yhcG	yhcG
yhcH	yhcH
nanK	nanK
nanE	nanE
nanT	nanT
nanA	nanA
nanR	nanR
dcuD	dcuD
sspB	sspB
sspA	sspA
rpsI	rpsI
rplM	rplM
yhcM	yhcM
yhcB	yhcB
degQ	degQ
degS	degS
mdh	mdh
argR	argR
yhcN	yhcN
yhcO	yhcO
aaeB	aaeB
aaeA	aaeA
aaeX	aaeX
aaeR	aaeR
tldD	tldD
yhdP	yhdP
rng	rng
yhdE	yhdE
mreD	mreD
mreC	mreC
mreB	mreB
yhdA	yhdA
yhdH	yhdH
accB	accB
accC	accC
yhdT	yhdT
panF	panF
prmA	prmA
dusB	dusB
fis	fis
yhdJ	yhdJ
yhdU	yhdU
envR	envR
acrE	acrE
acrF	acrF
yhdV	yhdV
yhdW	yhdW
yhdX	yhdX
yhdY	yhdY
yhdZ	yhdZ
rrfF	rrfF
thrV	thrV
rrfD	rrfD
rrlD	rrlD
alaU	alaU
ileU	ileU
rrsD	rrsD
yrdA	yrdA
yrdB	yrdB
aroE	aroE
yrdC	yrdC
yrdD	yrdD
smg	smg
smf	smf
def	def
fmt	fmt
rsmB	rsmB
trkA	trkA
mscL	mscL
yhdL	yhdL
zntR	zntR
yhdN	yhdN
rplQ	rplQ
rpoA	rpoA
rpsD	rpsD
rpsK	rpsK
rpsM	rpsM
rpmJ	rpmJ
secY	secY
rplO	rplO
rpmD	rpmD
rpsE	rpsE
rplR	rplR
rplF	rplF
rpsH	rpsH
rpsN	rpsN
rplE	rplE
rplX	rplX
rplN	rplN
rpsQ	rpsQ
rpmC	rpmC
rplP	rplP
rpsC	rpsC
rplV	rplV
rpsS	rpsS
rplB	rplB
rplW	rplW
rplD	rplD
rplC	rplC
rpsJ	rpsJ
pioO	pioO
gspA	gspA
gspC	gspC
gspD	gspD
gspE	gspE
gspF	gspF
gspG	gspG
gspH	gspH
gspI	gspI
gspJ	gspJ
gspK	gspK
gspL	gspL
gspM	gspM
gspO	gspO
bfr	bfr
bfd	bfd
chiA	chiA
tufA	tufA
fusA	fusA
rpsG	rpsG
rpsL	rpsL
yheL	yheL
yheM	yheM
yheN	yheN
yheO	yheO
fkpA	fkpA
slyX	slyX
slyD	slyD
yheV	yheV
kefB	kefB
kefG	kefG
yheS	yheS
yheT	yheT
yheU	yheU
prkB	prkB
yhfA	yhfA
crp	crp
yhfK	yhfK
argD	argD
pabA	pabA
fic	fic
yhfG	yhfG
ppiA	ppiA
tsgA	tsgA
nirB	nirB
nirD	nirD
nirC	nirC
cysG	cysG
yhfL	yhfL
frlA	frlA
frlB	frlB
frlC	frlC
frlD	frlD
frlR	frlR
yhfS	yhfS
yhfT	yhfT
yhfU	yhfU
php	php
yhfW	yhfW
yhfX	yhfX
yhfY	yhfY
yhfZ	yhfZ
trpS	trpS
gph	gph
rpe	rpe
dam	dam
damX	damX
aroB	aroB
aroK	aroK
hofQ	hofQ
yrfA	yrfA
yrfB	yrfB
yrfC	yrfC
yrfD	yrfD
mrcA	mrcA
nudE	nudE
yrfF	yrfF
yrfG	yrfG
hslR	hslR
hslO	hslO
yhgE	yhgE
pck	pck
envZ	envZ
ompR	ompR
greB	greB
yhgF	yhgF
feoA	feoA
feoB	feoB
yhgG	yhgG
yhgA	yhgA
bioH	bioH
gntX	gntX
gntY	gntY
gntT	gntT
malQ	malQ
malP	malP
malT	malT
rtcA	rtcA
rtcB	rtcB
rtcR	rtcR
glpR	glpR
glpG	glpG
glpE	glpE
glpD	glpD
yzgL	yzgL
glgP	glgP
glgA	glgA
glgC	glgC
glgX	glgX
glgB	glgB
asd	asd
yhgN	yhgN
gntU	gntU
gntK	gntK
gntR	gntR
yhhW	yhhW
yhhX	yhhX
ryhB	ryhB
yhhY	yhhY
yhhZ	yhhZ
yrhA	yrhA
yrhB	yrhB
ggt	ggt
yhhA	yhhA
ugpQ	ugpQ
ugpC	ugpC
ugpE	ugpE
ugpA	ugpA
ugpB	ugpB
livF	livF
livG	livG
livM	livM
livH	livH
livK	livK
yhhK	yhhK
livJ	livJ
rpoH	rpoH
ftsX	ftsX
ftsE	ftsE
ftsY	ftsY
yhhF	yhhF
yhhL	yhhL
yhhM	yhhM
yhhN	yhhN
zntA	zntA
yhhP	yhhP
yhhQ	yhhQ
dcrB	dcrB
yhhS	yhhS
yhhT	yhhT
acpT	acpT
nikA	nikA
nikB	nikB
nikC	nikC
nikD	nikD
nikE	nikE
nikR	nikR
rhsB	rhsB
yhhH	yhhH
yrhC	yrhC
yhhI	yhhI
yhhJ	yhhJ
rbbA	rbbA
yhiI	yhiI
yhiJ	yhiJ
yhiK	yhiK
yhiL	yhiL
yhiM	yhiM
yhiN	yhiN
pitA	pitA
yhiO	yhiO
uspA	uspA
yhiP	yhiP
yhiQ	yhiQ
prlC	prlC
yhiR	yhiR
gor	gor
arsR	arsR
arsB	arsB
arsC	arsC
yhiS	yhiS
slp	slp
yhiF	yhiF
yhiD	yhiD
hdeB	hdeB
hdeA	hdeA
hdeD	hdeD
gadE	gadE
mdtE	mdtE
mdtF	mdtF
gadW	gadW
IS183	IS183
gadX	gadX
gadA	gadA
yhjA	yhjA
treF	treF
yhjB	yhjB
yhjC	yhjC
yhjD	yhjD
yhjE	yhjE
yhjG	yhjG
yhjH	yhjH
kdgK	kdgK
yhjJ	yhjJ
dctA	dctA
yhjK	yhjK
bcsC	bcsC
bcsZ	bcsZ
bcsB	bcsB
bcsA	bcsA
yhjQ	yhjQ
yhjR	yhjR
bcsE	bcsE
bcsF	bcsF
bcsG	bcsG
ldrD	ldrD
rdlD	rdlD
yhjV	yhjV
dppF	dppF
dppD	dppD
dppC	dppC
dppB	dppB
dppA	dppA
proK	proK
eptB	eptB
yhjX	yhjX
yhjY	yhjY
tag	tag
yiaC	yiaC
bisC	bisC
yiaD	yiaD
tiaE	tiaE
yiaF	yiaF
yiaG	yiaG
cspA	cspA
hokA	hokA
insJ	insJ
insK	insK
glyS	glyS
glyQ	glyQ
ysaB	ysaB
yiaH	yiaH
yiaA	yiaA
yiaB	yiaB
xylB	xylB
xylA	xylA
xylF	xylF
xylG	xylG
xylH	xylH
xylR	xylR
bax	bax
malS	malS
avtA	avtA
yiaI	yiaI
yiaJ	yiaJ
yiaK	yiaK
yiaL	yiaL
yiaM	yiaM
yiaN	yiaN
yiaO	yiaO
lyxK	lyxK
sgbH	sgbH
sgbU	sgbU
sgbE	sgbE
yiaT	yiaT
yiaU	yiaU
yiaV	yiaV
yiaW	yiaW
aldB	aldB
yiaY	yiaY
selB	selB
selA	selA
yibF	yibF
rhsA	rhsA
yibA	yibA
yibJ	yibJ
yibG	yibG
yibH	yibH
yibI	yibI
mtlA	mtlA
mtlD	mtlD
mtlR	mtlR
yibT	yibT
yibL	yibL
lldP	lldP
lldR	lldR
lldD	lldD
yibK	yibK
cysE	cysE
gpsA	gpsA
secB	secB
grxC	grxC
yibN	yibN
gpmI	gpmI
envC	envC
yibQ	yibQ
yibD	yibD
tdh	tdh
kbl	kbl
htrL	htrL
rfaD	rfaD
rfaF	rfaF
rfaC	rfaC
rfaL	rfaL
rfaK	rfaK
rfaZ	rfaZ
rfaY	rfaY
rfaJ	rfaJ
rfaI	rfaI
rfaB	rfaB
rfaS	rfaS
rfaP	rfaP
rfaG	rfaG
rfaQ	rfaQ
kdtA	kdtA
coaD	coaD
mutM	mutM
rpmG	rpmG
rpmB	rpmB
yicR	yicR
dfp	dfp
dut	dut
ttk	ttk
pyrE	pyrE
rph	rph
yicC	yicC
dinD	dinD
yicG	yicG
ligB	ligB
gmk	gmk
rpoZ	rpoZ
spoT	spoT
trmH	trmH
recG	recG
gltS	gltS
yicE	yicE
yicH	yicH
yicI	yicI
yicJ	yicJ
selC	selC
setC	setC
yicL	yicL
nlpA	nlpA
yicS	yicS
yicM	yicM
yicN	yicN
yicO	yicO
ade	ade
uhpT	uhpT
uhpC	uhpC
uhpB	uhpB
uhpA	uhpA
ilvN	ilvN
ilvB	ilvB
ivbL	ivbL
emrD	emrD
yidF	yidF
yidG	yidG
yidH	yidH
yidI	yidI
yidJ	yidJ
yidK	yidK
yidL	yidL
ysdC	ysdC
glvG	glvG
glvB	glvB
glvC	glvC
yidP	yidP
yidE	yidE
ibpB	ibpB
ibpA	ibpA
yidQ	yidQ
yidR	yidR
cbrA	cbrA
dgoT	dgoT
dgoD	dgoD
dgoA	dgoA
dgoK	dgoK
dgoR	dgoR
yidX	yidX
yidA	yidA
yidB	yidB
gyrB	gyrB
recF	recF
dnaN	dnaN
dnaA	dnaA
rpmH	rpmH
rnpA	rnpA
yidD	yidD
yidC	yidC
trmE	trmE
tnaC	tnaC
tnaA	tnaA
tnaB	tnaB
mdtL	mdtL
yidZ	yidZ
yieE	yieE
yieF	yieF
yieG	yieG
yieH	yieH
yieI	yieI
cbrC	cbrC
yieK	yieK
yieL	yieL
bglH	bglH
bglB	bglB
bglF	bglF
bglG	bglG
phoU	phoU
pstB	pstB
pstA	pstA
pstC	pstC
pstS	pstS
glmS	glmS
glmU	glmU
atpC	atpC
atpD	atpD
atpG	atpG
atpA	atpA
atpH	atpH
atpF	atpF
atpE	atpE
atpB	atpB
atpI	atpI
gidB	gidB
gidA	gidA
oriC	oriC
mioC	mioC
asnC	asnC
asnA	asnA
yieM	yieM
yieN	yieN
trkD	trkD
rbsD	rbsD
rbsA	rbsA
rbsC	rbsC
rbsB	rbsB
rbsK	rbsK
rbsR	rbsR
hsrA	hsrA
yieP	yieP
rrsC	rrsC
gltU	gltU
rrlC	rrlC
rrfC	rrfC
aspT	aspT
trpT	trpT
hdfR	hdfR
yifE	yifE
yifB	yifB
ilvL	ilvL
ilvG_1	ilvG_1
ilvG_2	ilvG_2
ilvG	ilvG
ilvM	ilvM
ilvE	ilvE
ilvD	ilvD
ilvA	ilvA
ilvY	ilvY
ilvC	ilvC
ppiC	ppiC
yifO	yifO
yifN	yifN
rep	rep
gpp	gpp
rhlB	rhlB
trxA	trxA
rhoL	rhoL
rho	rho
rfe	rfe
wzzE	wzzE
rffE	rffE
rffD	rffD
rffG	rffG
rffH	rffH
rffC	rffC
rffA	rffA
wzxE	wzxE
rffT	rffT
wzyE	wzyE
rffM	rffM
yifK	yifK
argX	argX
hisR	hisR
leuT	leuT
proM	proM
aslB	aslB
aslA	aslA
ryiA	ryiA
hemY	hemY
hemX	hemX
hemD	hemD
hemC	hemC
cyaA	cyaA
cyaY	cyaY
yzcX	yzcX
yifL	yifL
dapF	dapF
yigA	yigA
xerC	xerC
yigB	yigB
uvrD	uvrD
yigE	yigE
corA	corA
yigF	yigF
yigG	yigG
rarD	rarD
yigI	yigI
pldA	pldA
recQ	recQ
rhtC	rhtC
rhtB	rhtB
pldB	pldB
yigL	yigL
yigM	yigM
metR	metR
metE	metE
ysgA	ysgA
udp	udp
rmuC	rmuC
ubiE	ubiE
yigP	yigP
ubiB	ubiB
tatA	tatA
tatB	tatB
tatC	tatC
tatD	tatD
rfaH	rfaH
ubiD	ubiD
fre	fre
fadA	fadA
fadB	fadB
pepQ	pepQ
yigZ	yigZ
trkH	trkH
hemG	hemG
rrsA	rrsA
ileT	ileT
alaT	alaT
rrlA	rrlA
rrfA	rrfA
mobB	mobB
mobA	mobA
yihD	yihD
yihE	yihE
dsbA	dsbA
yihF	yihF
yihG	yihG
polA	polA
spf	spf
yihA	yihA
csrC	csrC
yihI	yihI
hemN	hemN
glnG	glnG
glnL	glnL
glnA	glnA
bipA	bipA
yihL	yihL
yihM	yihM
yihN	yihN
ompL	ompL
yihO	yihO
yihP	yihP
yihQ	yihQ
yihR	yihR
yihS	yihS
yihT	yihT
yihU	yihU
yihV	yihV
yihW	yihW
yihX	yihX
rbn	rbn
dtd	dtd
yiiD	yiiD
yiiE	yiiE
yiiF	yiiF
fdhE	fdhE
fdoI	fdoI
fdoH	fdoH
fdoG	fdoG
fdhD	fdhD
yiiG	yiiG
frvR	frvR
frvX	frvX
frvB	frvB
frvA	frvA
yiiL	yiiL
rhaD	rhaD
rhaA	rhaA
rhaB	rhaB
rhaS	rhaS
rhaR	rhaR
rhaT	rhaT
sodA	sodA
kdgT	kdgT
yiiM	yiiM
cpxA	cpxA
cpxR	cpxR
cpxP	cpxP
fieF	fieF
pfkA	pfkA
sbp	sbp
cdh	cdh
tpiA	tpiA
yiiQ	yiiQ
yiiR	yiiR
yiiS	yiiS
yiiT	yiiT
fpr	fpr
glpX	glpX
glpK	glpK
glpF	glpF
yiiU	yiiU
rraA	rraA
menA	menA
hslU	hslU
hslV	hslV
ftsN	ftsN
cytR	cytR
priA	priA
rpmE	rpmE
yiiX	yiiX
metJ	metJ
metB	metB
metL	metL
metF	metF
katG	katG
yijE	yijE
yijF	yijF
gldA	gldA
fsaB	fsaB
ptsA	ptsA
frwC	frwC
frwB	frwB
pflD	pflD
pflC	pflC
frwD	frwD
yijO	yijO
yijP	yijP
ppc	ppc
argE	argE
argC	argC
argB	argB
argH	argH
oxyS	oxyS
oxyR	oxyR
sthA	sthA
fabR	fabR
yijD	yijD
trmA	trmA
btuB	btuB
murI	murI
rrsB	rrsB
gltT	gltT
rrlB	rrlB
rrfB	rrfB
murB	murB
birA	birA
coaA	coaA
thrU	thrU
tyrU	tyrU
glyT	glyT
thrT	thrT
tufB	tufB
secE	secE
nusG	nusG
rplK	rplK
rplA	rplA
rplJ	rplJ
rplL	rplL
rpoB	rpoB
rpoC	rpoC
htrC	htrC
thiH	thiH
thiG	thiG
thiS	thiS
thiF	thiF
thiE	thiE
thiC	thiC
rsd	rsd
nudC	nudC
hemE	hemE
nfi	nfi
yjaG	yjaG
hupA	hupA
yjaH	yjaH
zraP	zraP
zraS	zraS
zraR	zraR
purD	purD
purH	purH
rrsE	rrsE
gltV	gltV
rrlE	rrlE
rrfE	rrfE
yjaA	yjaA
yjaB	yjaB
metA	metA
aceB	aceB
aceA	aceA
aceK	aceK
arpA	arpA
iclR	iclR
metH	metH
yjbB	yjbB
pepE	pepE
yjbC	yjbC
yjbD	yjbD
lysC	lysC
pgi	pgi
yjbE	yjbE
yjbF	yjbF
yjbG	yjbG
yjbH	yjbH
yjbA	yjbA
xylE	xylE
malG	malG
malF	malF
malE	malE
malK	malK
lamB	lamB
malM	malM
yjbI	yjbI
ubiC	ubiC
ubiA	ubiA
plsB	plsB
dgkA	dgkA
lexA	lexA
dinF	dinF
yjbJ	yjbJ
zur	zur
yjbL	yjbL
yjbM	yjbM
yjbN	yjbN
yjbO	yjbO
qor	qor
dnaB	dnaB
alr	alr
tyrB	tyrB
aphA	aphA
yjbQ	yjbQ
yjbR	yjbR
uvrA	uvrA
ssb	ssb
yjcB	yjcB
yjcC	yjcC
soxS	soxS
soxR	soxR
ryjA	ryjA
yjcD	yjcD
yjcE	yjcE
yjcF	yjcF
actP	actP
yjcH	yjcH
acs	acs
nrfA	nrfA
nrfB	nrfB
nrfC	nrfC
nrfD	nrfD
nrfE	nrfE
nrfF	nrfF
nrfG	nrfG
gltP	gltP
yjcO	yjcO
fdhF	fdhF
yjcP	yjcP
yjcQ	yjcQ
yjcR	yjcR
yjcS	yjcS
alsK	alsK
alsE	alsE
alsC	alsC
alsA	alsA
alsB	alsB
rpiR	rpiR
rpiB	rpiB
yjdP	yjdP
phnP	phnP
phnO	phnO
phnN	phnN
phnM	phnM
phnL	phnL
phnK	phnK
phnJ	phnJ
phnI	phnI
phnH	phnH
phnG	phnG
phnF	phnF
phnE	phnE
phnD	phnD
phnC	phnC
phnB	phnB
phnA	phnA
yjdA	yjdA
yjcZ	yjcZ
proP	proP
basS	basS
basR	basR
eptA	eptA
adiC	adiC
adiY	adiY
adiA	adiA
melR	melR
melA	melA
melB	melB
yjdF	yjdF
fumB	fumB
dcuB	dcuB
dcuR	dcuR
dcuS	dcuS
yjdI	yjdI
yjdJ	yjdJ
yjdK	yjdK
yjdO	yjdO
lysU	lysU
yjdL	yjdL
cadA	cadA
cadB	cadB
cadC	cadC
pheU	pheU
yjdC	yjdC
dipZ	dipZ
cutA	cutA
dcuA	dcuA
aspA	aspA
fxsA	fxsA
yjeH	yjeH
groS	groS
groL	groL
yjeI	yjeI
yjeJ	yjeJ
yjeK	yjeK
efp	efp
ecnA	ecnA
ecnB	ecnB
sugE	sugE
blc	blc
ampC	ampC
frdD	frdD
frdC	frdC
frdB	frdB
frdA	frdA
poxA	poxA
yjeM	yjeM
yjeN	yjeN
yjeO	yjeO
yjeP	yjeP
psd	psd
rsgA	rsgA
orn	orn
glyV	glyV
glyX	glyX
glyY	glyY
yjeS	yjeS
yjeF	yjeF
yjeE	yjeE
amiB	amiB
mutL	mutL
miaA	miaA
hfq	hfq
hflX	hflX
hflK	hflK
hflC	hflC
yjeT	yjeT
purA	purA
yjeB	yjeB
rnr	rnr
rlmB	rlmB
yjfI	yjfI
yjfJ	yjfJ
yjfK	yjfK
yjfL	yjfL
yjfM	yjfM
yjfC	yjfC
aidB	aidB
yjfN	yjfN
yjfO	yjfO
yjfP	yjfP
ulaR	ulaR
ulaG	ulaG
ulaA	ulaA
ulaB	ulaB
ulaC	ulaC
ulaD	ulaD
ulaE	ulaE
ulaF	ulaF
yjfY	yjfY
rpsF	rpsF
priB	priB
rpsR	rpsR
rplI	rplI
yjfZ	yjfZ
ytfA	ytfA
ytfB	ytfB
fklB	fklB
cycA	cycA
ytfE	ytfE
ytfF	ytfF
ytfG	ytfG
ytfH	ytfH
cpdB	cpdB
cysQ	cysQ
ytfI	ytfI
ytfJ	ytfJ
ytfK	ytfK
ytfL	ytfL
msrA	msrA
ytfM	ytfM
ytfN	ytfN
ytfP	ytfP
yzfA	yzfA
chpS	chpS
chpB	chpB
ppa	ppa
ytfQ	ytfQ
ytfR	ytfR
ytfT	ytfT
yjfF	yjfF
fbp	fbp
mpl	mpl
yjgA	yjgA
pmbA	pmbA
cybC	cybC
nrdG	nrdG
nrdD	nrdD
treC	treC
treB	treB
treR	treR
mgtA	mgtA
yjgF	yjgF
pyrI	pyrI
pyrB	pyrB
pyrL	pyrL
yjgH	yjgH
yjgI	yjgI
yjgJ	yjgJ
yjgK	yjgK
yjgL	yjgL
argI	argI
yjgD	yjgD
yjgM	yjgM
yjgN	yjgN
valS	valS
holC	holC
pepA	pepA
yjgP	yjgP
yjgQ	yjgQ
yjgR	yjgR
idnR	idnR
idnT	idnT
idnO	idnO
idnD	idnD
idnK	idnK
yjgB	yjgB
leuX	leuX
intB	intB
yjgW	yjgW
yjgX_2	yjgX_2
yjgX_1	yjgX_1
yjgX_3	yjgX_3
yjgX	yjgX
yjgZ	yjgZ
insG	insG
yjhB	yjhB
yjhC	yjhC
yjhD	yjhD
yjhE	yjhE
insM	insM
insO-2	insO-2
yjhW	yjhW
yjhV	yjhV
fecE	fecE
fecD	fecD
fecC	fecC
fecB	fecB
fecA	fecA
fecR	fecR
fecI	fecI
yjhU	yjhU
yjhF	yjhF
yjhG	yjhG
yjhH	yjhH
yjhI	yjhI
sgcR	sgcR
sgcE	sgcE
sgcA	sgcA
sgcQ	sgcQ
sgcC	sgcC
sgcB	sgcB
sgcX	sgcX
yjhP	yjhP
yjhQ	yjhQ
yjhX	yjhX
yjhR	yjhR
yjhS	yjhS
yjhT	yjhT
yjhA	yjhA
fimB	fimB
fimE	fimE
fimA	fimA
fimI	fimI
fimC	fimC
fimD	fimD
fimF	fimF
fimG	fimG
fimH	fimH
gntP	gntP
uxuA	uxuA
uxuB	uxuB
uxuR	uxuR
yjiC	yjiC
yjiD	yjiD
yjiE	yjiE
iadA	iadA
yjiG	yjiG
yjiH	yjiH
kptA	kptA
yjiJ	yjiJ
yjiK	yjiK
yjiL	yjiL
yjiM	yjiM
yjiN	yjiN
yjiO	yjiO
yjiP	yjiP
yjiQ	yjiQ
yjiR	yjiR
yjiS	yjiS
yjiT	yjiT
yjiV	yjiV
mcrC	mcrC
mcrB	mcrB
yjiW	yjiW
hsdS	hsdS
hsdM	hsdM
hsdR	hsdR
mrr	mrr
yjiA	yjiA
yjiX	yjiX
yjiY	yjiY
tsr	tsr
yjiZ	yjiZ
yjjM	yjjM
yjjN	yjjN
mdoB	mdoB
yjjA	yjjA
dnaC	dnaC
dnaT	dnaT
yjjB	yjjB
yjjP	yjjP
yjjQ	yjjQ
bglJ	bglJ
fhuF	fhuF
yjjZ	yjjZ
leuV	leuV
leuP	leuP
leuQ	leuQ
rsmC	rsmC
holD	holD
rimI	rimI
yjjG	yjjG
prfC	prfC
osmY	osmY
ytjA	ytjA
yjjU	yjjU
yjjV	yjjV
yjjW	yjjW
yjjI	yjjI
deoC	deoC
deoA	deoA
deoB	deoB
deoD	deoD
yjjJ	yjjJ
lplA	lplA
ytjB	ytjB
serB	serB
radA	radA
nadR	nadR
yjjK	yjjK
slt	slt
trpR	trpR
yjjX	yjjX
ytjC	ytjC
rob	rob
creA	creA
creB	creB
creC	creC
creD	creD
arcA	arcA
yjjY	yjjY
lasT	lasT
